111111111111111111111111111111111111111111111111111111111111111111111111111111111111111111111111111111111111111111111111111111111111111111
100P00000000000000000000000000000000000000000000000000000000000000000000000000000000C00000000000000000000000000000000000000000000000000E11
111111111111111111111111111111111111111111111111111111111111111111111111111111111111111111111111111111111111111111111111111111111111111111
