1111111111
1P00010001
1011010101
1C01000101
1001111101
10100C0001
1010111C11
1000000E01
1111111111
