111111111111111
1P00000000000C1
101111111111101
100000000000101
111111110110101
10C000010100101
101111010111101
100001000000001
111111111111C11
100000000000E01
111111111111111
