111111111111111111
1P00100000000000C1
101011111111111101
101000000010000001
101111111110111101
10000000010C000101
111111110111110101
100000010000010001
101111011111011101
1C0001000C00000C01
111111111111111101
100000000000000E01
111111111111111111
