11111111
1P0C0001
10111101
10000C01
100E1111
11111111
