111111111111
1P00100000C1
101010111101
101C10000101
100011110101
111000010001
101111011101
1000C0010001
111111010C11
100000000E01
111111111111
