1111111111
1C100001C1
1010000101
1000110001
1C0C1P0111
11111000C1
1C00000111
1110C10001
1E001111C1
1111111111
