1111111111111111111111111111111
1C0000N00000000000N00000N000001
1NNN00N00NNNN00NNNN00NNNN00NNN1
100000000N00000000N00N00N000001
100N00NNNNNNNNNN00N00N00N00N001
100N00000N00000000000N00000N001
100N00NNNN00NNNN00NNNN00NNNN001
100N00000N00N00N00N00N00000N001
100NNNNNNN00N00N00N00N00N00N001
100000N00N00N00N00000000N00N001
1NNNNNN00NNNN00N00NNNN00NNNN001
100N00N00000N00000N00000000N001
100N00N00NNNN00N00N00N00N00NNN1
100000N00000N00N00N00N00N000001
1NNN00NNNN00NNNNNNN00NNNN00NNN1
100000000N00N00000000N000000001
1NNN00N00N00NNNNNNNNNNNNNNNN001
100N00N00N00000000000N00N000001
100N00N00N00N00NNNN00N00N00N001
10000EN00000N00N00000000000NP01
1111111111111111111111111111111
